11111111111111111111111111111111
1P00000001000C000000000100011111
10000000010000000000000100011111
100000000100000000000001C0000111
10000000000000000000000111110111
11100000111110000010000000000001
1000000010C010000010000100000001
10000000100010000010000100011101
10000000100010000010000100000101
1C00000000000000001000010000E0C1
11111111111111111111111111111111