111111111111111
1000E0PC0001001
111111111111111