1111111111111
1P01000000001
1CE0011111001
1000110000001
1111111111111